000000000000122222
000000000000122222
003000300000122222
003000300000122222
003000300000122222
003333333300122222
000000000000122222