000000000000000122
000333330000001222
000300030000022222
000333330000001222
000000000000000122