222222000000022222
222220000000002222
222200000000001222
222000000000001222
220000000000001222
220000000000001222
222000000000001222
222200000000002222
222220000000222222