000000000000000122
000000000300223122
000000000330223122
000000000300223122
000000000000000122