000002000030100222
000000000000000012
000002000030000222
000000020030000222
000000000000000002